x xxxxxxxxx xxx x
x     x   x     x
x x x x x x x x x
x x x   x   x x x
  x xxx x xxx x  
x x   x x x   x x
x xxx x   x xxx x
x x   x x x   x x
x x x   x   x x x
x   xxxxxxxxx   x
xxx x       x xxx
  x x xxxxx      
x   x x   xxx xxx
x x   x x   x   x
x xxxxxxxxx xxx x